###############
#             #
#G     P     G#
#             #
###############